19 19 19 19 19 19 19 19 19 19 19 19 19 19 19 19 19 19 19 19 19 19 19 19 19 19 19 19 19 19 19 19 19 19 19 19 19 19 19 19 19 19 19 19 19 19 19 19 19 19 
19 19 19 19 19 19 19 19 19 19 19 19 19 19 19 19 19 19 19 19 19 19 19 19 19 19 19 19 19 19 19 19 19 19 19 19 19 19 19 19 19 19 19 19 19 19 19 19 19 19 
19 19 19 19 2 19 19 19 19 19 19 19 19 19 19 19 2 3 2 2 2 2 2 2 2 2 2 2 2 2 23 24 24 24 24 24 24 24 24 24 24 24 24 24 24 25 19 19 19 19 
19 19 19 2 2 3 19 19 19 19 19 19 19 19 19 2 2 2 2 2 18 18 2 18 18 2 18 18 2 2 26 21 21 21 21 21 21 21 21 21 21 21 21 21 21 33 24 25 19 19 
19 19 3 2 4 3 3 19 19 19 19 19 19 19 3 3 3 2 2 2 2 2 2 2 2 2 2 2 2 2 26 21 21 21 21 21 21 21 21 21 21 21 21 22 22 21 21 27 19 19 
19 19 19 2 3 2 19 19 19 19 19 19 19 19 2 2 2 2 2 23 24 24 24 24 24 24 24 24 24 24 34 21 21 21 21 21 21 21 21 21 21 21 22 22 21 21 21 27 2 19 
19 19 19 19 2 19 19 19 19 19 19 19 19 19 19 2 2 2 2 26 21 21 21 21 21 21 21 21 21 21 21 21 21 21 21 21 21 21 21 21 21 22 22 21 31 29 29 30 2 19 
19 19 19 19 5 19 19 19 19 19 19 19 19 19 19 2 2 2 2 26 21 21 21 21 21 21 21 21 21 21 21 21 21 21 21 22 22 22 22 21 21 21 21 21 27 2 2 2 2 19 
19 19 19 19 5 5 5 19 19 19 19 19 19 19 19 2 2 2 2 26 21 21 21 21 21 21 21 21 21 21 21 21 21 21 22 22 22 22 21 21 21 21 21 21 27 2 2 2 2 19 
19 19 19 19 19 19 5 19 19 19 19 19 19 19 19 2 3 2 2 26 21 21 21 21 21 21 21 21 21 21 21 21 21 21 21 21 21 21 21 21 21 21 21 21 27 2 2 2 19 19 
19 19 19 19 19 19 5 5 5 5 2 2 19 19 19 19 2 2 2 26 21 21 21 21 21 21 21 21 21 21 21 21 21 21 21 21 21 21 21 21 21 21 21 21 27 2 2 2 19 19 
19 19 19 19 19 19 19 19 19 19 19 2 19 19 19 19 2 2 2 26 21 21 21 21 21 21 21 21 21 21 21 21 21 21 21 21 21 31 29 29 29 29 29 29 30 2 2 19 19 19 
19 19 19 19 19 19 19 19 19 19 19 3 19 19 19 19 19 2 2 26 21 21 21 21 21 21 21 21 21 21 21 21 21 21 21 21 21 27 2 2 2 2 2 2 2 2 2 19 19 19 
19 19 19 19 19 19 19 19 19 19 19 3 19 19 19 19 19 2 2 26 21 21 21 21 21 22 22 22 21 21 21 21 21 21 21 21 21 27 2 2 2 2 2 2 2 2 2 19 19 19 
19 19 19 19 19 19 19 19 19 19 19 3 3 2 2 2 2 2 2 26 21 21 21 21 22 22 22 21 21 21 21 21 21 22 22 21 21 27 2 2 19 19 19 14 12 12 15 19 19 19 
19 19 19 19 19 19 19 19 19 19 19 2 2 19 19 19 19 2 2 26 21 21 21 21 21 21 21 21 21 21 21 21 22 22 22 21 21 27 2 2 19 19 19 10 5 5 9 19 19 19 
19 19 19 19 19 19 19 19 19 19 19 19 19 19 19 19 19 2 2 26 21 21 21 21 21 21 21 21 21 21 21 21 21 21 21 21 21 27 2 2 19 19 19 10 5 5 9 19 19 19 
19 19 19 19 19 19 19 19 19 19 19 19 19 19 19 19 19 2 2 26 21 21 21 21 21 21 21 21 21 21 21 21 21 21 21 21 21 27 2 2 19 19 19 10 5 5 9 19 19 19 
19 19 19 19 19 19 19 19 19 19 19 19 19 19 19 19 19 2 2 28 29 29 29 29 29 29 29 29 29 29 29 29 29 29 29 29 29 30 2 2 19 19 19 10 5 5 9 19 19 19 
19 19 19 19 19 19 19 19 19 19 19 19 19 19 19 19 19 2 2 3 3 3 2 2 2 2 2 2 2 3 3 2 2 2 2 2 2 2 2 3 19 19 19 10 5 5 9 19 19 19 
19 19 19 19 19 19 19 19 19 19 19 19 19 19 19 19 19 2 3 3 2 2 19 19 19 19 19 19 3 3 2 2 2 3 3 3 3 3 3 19 19 19 19 10 5 5 9 19 19 19 
19 19 19 19 19 19 19 19 19 2 18 18 18 3 2 2 3 3 2 20 19 19 19 19 19 19 19 19 19 19 19 19 19 19 19 19 19 19 19 19 19 19 19 10 5 5 9 19 19 19 
19 19 19 19 19 19 19 19 20 3 2 2 2 2 2 2 3 2 20 19 19 19 19 19 19 19 19 19 19 19 19 19 19 19 19 19 19 19 19 19 19 19 19 10 5 5 9 19 19 19 
19 19 19 19 19 19 19 20 2 2 2 2 3 3 3 3 2 20 19 19 19 19 3 3 3 3 3 3 2 19 19 19 19 19 19 19 19 19 19 19 19 19 3 10 5 5 9 19 19 19 
19 19 19 19 19 19 20 2 2 3 3 2 2 3 3 3 2 19 19 19 19 2 2 2 2 2 2 3 2 3 2 2 3 3 2 2 2 2 2 3 3 3 3 10 5 5 9 19 19 19 
19 19 19 19 19 20 2 2 23 24 24 24 25 3 3 3 18 19 19 19 2 2 2 23 24 25 14 12 12 12 12 12 12 12 12 12 12 12 12 12 12 12 12 13 5 5 9 19 19 19 
19 19 19 19 2 2 2 2 26 21 21 21 27 2 2 2 18 19 19 19 2 18 2 26 21 27 10 5 5 5 5 5 5 5 5 5 5 5 5 5 5 5 5 5 5 5 9 19 19 19 
19 19 19 19 18 3 2 3 26 21 21 21 27 2 3 2 18 19 19 19 3 18 2 26 21 27 10 5 5 5 5 5 5 5 5 5 5 5 5 5 5 5 5 5 5 5 9 19 19 19 
19 19 19 19 18 3 2 2 26 21 31 29 30 2 2 2 18 19 19 19 2 2 2 28 29 30 16 7 7 7 7 7 7 7 7 7 7 7 7 7 7 7 7 8 5 5 9 19 19 19 
19 19 19 19 18 3 2 3 26 21 27 3 3 3 2 2 2 19 19 19 19 2 2 2 2 2 2 3 3 3 3 3 3 3 2 3 2 3 3 3 2 2 2 10 5 5 9 19 19 19 
19 19 19 19 2 2 3 3 28 29 30 3 3 3 3 2 2 20 19 19 19 19 2 2 2 2 2 2 2 19 19 19 19 19 19 19 19 19 19 19 19 19 19 10 5 5 9 19 19 19 
19 19 19 19 19 20 2 2 2 2 2 3 3 2 2 2 2 2 20 19 19 19 19 19 19 19 19 19 19 19 19 19 19 19 19 19 19 19 19 19 19 19 19 10 5 5 9 19 19 19 
19 19 19 19 19 19 20 2 2 2 2 2 3 3 3 3 3 3 2 20 19 19 19 19 19 19 19 19 19 19 19 19 19 19 19 19 19 19 19 19 19 19 19 10 5 5 9 19 19 19 
19 19 19 19 19 19 19 19 19 19 19 19 2 3 2 3 3 3 2 2 2 2 19 19 19 19 19 19 19 19 19 19 19 19 19 19 19 19 19 19 19 19 19 10 5 5 9 19 19 19 
19 19 19 19 19 19 19 19 19 19 19 19 19 2 2 3 3 3 2 2 3 2 2 2 2 2 19 19 19 19 19 19 19 19 19 19 19 19 19 19 19 19 19 10 5 5 9 19 19 19 
19 19 19 19 20 20 20 20 20 20 20 20 20 19 2 2 2 3 3 3 2 2 3 3 2 2 2 19 19 19 19 19 19 19 19 19 19 19 19 19 19 19 19 10 5 5 9 19 19 19 
19 19 19 20 20 20 20 20 20 20 20 20 20 19 19 2 2 2 3 3 3 3 3 3 2 19 19 19 19 19 19 19 19 19 19 19 19 19 19 19 19 19 19 10 5 5 9 19 19 19 
19 19 20 20 2 2 3 3 3 3 2 2 2 20 19 19 2 2 3 3 2 2 2 2 19 19 19 19 19 19 19 19 19 19 19 19 19 19 19 19 19 19 19 10 5 5 9 19 19 19 
19 20 20 19 19 3 3 4 4 19 19 2 3 3 20 19 19 2 2 2 19 19 19 19 19 19 19 19 19 19 19 19 19 19 19 19 19 19 19 19 19 19 19 10 5 5 9 19 19 19 
20 20 19 19 4 4 2 1 1 1 2 2 3 3 3 20 19 2 2 19 19 19 19 19 19 19 19 19 19 19 19 19 19 19 19 19 19 19 19 19 19 19 19 10 5 5 9 19 19 19 
20 20 2 2 1 1 1 1 2 1 4 4 4 3 3 20 20 2 19 19 19 19 19 19 19 19 19 19 19 19 19 19 19 19 19 19 19 19 19 19 19 19 19 10 5 5 9 19 19 19 
20 20 19 19 2 2 2 2 2 1 1 1 1 19 19 12 12 12 12 12 12 12 12 12 12 12 12 12 12 12 12 12 12 12 12 12 12 12 12 12 12 12 12 13 5 5 9 19 19 19 
20 20 2 4 2 2 4 4 1 1 2 2 1 1 1 5 5 5 5 5 5 5 5 5 5 5 5 5 5 5 5 5 5 5 5 5 5 5 5 5 5 5 5 5 5 5 9 19 19 19 
20 20 2 1 1 1 1 1 1 2 2 2 1 1 1 5 5 5 5 5 5 5 5 5 5 5 5 5 5 5 5 5 5 5 5 5 5 5 5 5 5 5 5 5 5 5 9 19 19 19 
20 20 2 19 2 2 3 3 3 19 4 4 1 19 19 7 7 7 7 7 7 7 7 7 7 7 7 7 7 7 7 7 7 7 7 7 7 7 7 7 7 7 7 7 7 7 17 19 19 19 
20 20 19 19 4 2 1 1 1 1 1 1 1 2 2 20 20 19 19 19 19 19 19 19 19 19 19 19 19 19 19 19 19 19 19 19 19 19 19 19 19 19 19 19 19 19 19 19 19 19 
20 20 2 3 1 1 1 2 4 4 19 1 2 2 2 20 20 19 19 19 19 19 19 19 19 19 19 19 19 19 19 19 19 19 19 19 19 19 19 19 19 19 19 19 19 19 19 19 19 19 
19 20 20 2 2 4 4 1 1 1 1 1 2 2 20 20 19 19 19 19 19 19 19 19 19 19 19 19 19 19 19 19 19 19 19 19 19 19 19 19 19 19 19 19 19 19 19 19 19 19 
19 19 20 20 2 1 1 1 2 2 2 2 2 20 20 19 19 19 19 19 19 19 19 19 19 19 19 19 19 19 19 19 19 19 19 19 19 19 19 19 19 19 19 19 19 19 19 19 19 19 
19 19 19 20 20 20 20 20 20 20 20 20 20 20 19 19 19 19 19 19 19 19 19 19 19 19 19 19 19 19 19 19 19 19 19 19 19 19 19 19 19 19 19 19 19 19 19 19 19 19 
